P N N N W Z N N N N
N N N N W N W N C N
N W Z N W N W N N N
N W N N W N W N R N
N W B N N N N N N N
C W W W W N N N Z N
N N W B N N W W N N
N R W W N N N B N N
N N N N N W N Z N N
B N N W W W N N N G