P N N N W Z N N N N
N N N N W N W N C N
N W Z N W B W N N N
N W N N W W W N R N
N W B N N N N N N N
C W N N N N N N Z N
N N N W W W W N N N
N R N W N N N B N N
N N N N N W N Z N N
B N Z W W W N N N G 